1111111111111111111111111111111111111111111111111111111111111111111111111111
1001000000001100100000000110010000000011001000000001001000000001001000000001
1000000000C00000000000000110010000000011001000000001001000000001001000000001
1P001100E0101100100000000110010000000011001000000001001000000001001000000001
1000011111C00000100000000110010000000011001000000001001000000001001000000001
1000011110C01100100000000110010000000011001000000001001000000001001000000001
1000011110C01100100000000110010000000011001000000001001000000001001000000001
1000011110C01100100000000110010000000011001000000001001000000001001000000001
1000011110C01100100000000110010000000011001000000001001000000001001000000001
1000011110C01100100000000110010000000011001000000001001000000001001000000001
1000011110C01100100000000110010000000011001000000001001000000001001000000001
1000011110C01100100000000110010000000011001000000001001000000001001000000001
1000011110C01100100000000110010000000011001000000001001000000001001000000001
1000011110C01100100000000110010000000011001000000001001000000001001000000001
1000011110C01100100000000110010000000011001000000001001000000001001000000001
1000011110C01100100000000110010000000011001000000001001000000001001000000001
1000011110C01100100000000110010000000011001000000001001000000001001000000001
1000011110C01100100000000110010000000011001000000001001000000001001000000001
1000011110C01100100000000110010000000011001000000001001000000001001000000001
1000011110C01100100000000110010000000011001000000001001000000001001000000001
1000011110C01100100000000110010000000011001000000001001000000001001000000001
1000011110C01100100000000110010000000011001000000001001000000001001000000001
1000011110C01100100000000110010000000011001000000001001000000001001000000001
1000011110C01100100000000110010000000011001000000001001000000001001000000001
1000011110C01100100000000110010000000011001000000001001000000001001000000001
1000011110C01100100000000110010000000011001000000001001000000001001000000001
1000011110C01100100000000110010000000011001000000001001000000001001000000001
1000011110C01100100000000110010000000011001000000001001000000001001000000001
1000011110C01100100000000110010000000011001000000001001000000001001000000001
1000011110C01100100000000110010000000011001000000001001000000001001000000001
1000011110C01100100000000110010000000011001000000001001000000001001000000001
1000011110C01100100000000110010000000011001000000001001000000001001000000001
1000011110C01100100000000110010000000011001000000001001000000001001000000001
1111111111111111111111111111111111111111111111111111111111111111111111111111