1111111111111
1000000000001
1000011110C01
1P001100E0101
1111111111111