111111111111111111111111111111111111111
1P00000001000000000000000000000000000C1
100000000100000000000000100000000010001
100000000100000000000000100000000010001
100000000100000000000000100000000010001
100000000100000000000000100000000010001
100000000000000000000000C00000000C100E1
111111111111111111111111111111111111111